R 800           800

SO ./assets/textures/space_door.xpm
NO ./assets/textures/space_closet.xpm

C 122,   135,  159


WE ./assets/textures/space_win.xpm
F 64,73,89
EA ./assets/textures/space_cmd.xpm

    11111    
  110000011  
 11000000011 
 10000000001 
1000000000001
1000000000001
1000001000001
1000000000001
1000000000001
 10000S00001 
 11000000011 
  110000011  
    11111
1