R 800           800

SO ./assets/textures/space_door.xpm
NO ./assets/textures/space_closet.xpm

C 122,   135,  159


WE ./assets/textures/space_win.xpm
F 64,73,89
EA ./assets/textures/space_cmd.xpm

        11111          11111
    111111111       1111111111111
    100000001       10010001
    1111100111       1001001111
        100111       1001000011
        10000111111111001111011111
        10E0000000000000000000001
        1001111001110000111100001
        1001000000000000100100001
111111111011000001110000111100001
1000000000110000011101111111111111
11110111111111011100000010001   1
11110111111111011101010010001
11000000110101011100000010001
100000000000000001100000010001
10000000000000001101010010001
110000011101010101110111100111
111111111111111111111111111
1001
11111111111111111111111111111