R 1000           800

NO ./assets/textures/north_texture.xpm
SO ./assets/textures/south_texture.xpm

C 225,   30,   0


WE ./assets/textures/west_texture.xpm
F 220,100,0
EA ./assets/textures/east_texture.xpm

    1111111111
    100000011
    11111001
        1001
        1000111111111111111111111
        10N0000000110000000000001
        1011000001110000101100001
        10010000000000001  1000001
111111111011000001110000111100001
1000000000110000011101111111111111
11110111111111011100000010001   1
11110111111111011101010010001
11000000110101011100000010001
10000000000000001100000010001
10000000000000001101010010001
110000011101010111110111100111
11110111 1110101 101111010001
11111111 1111111 111111111111