R 1920           1080

NO ./assets/path_to_the_north_texture
SO ./assets/path_to_the_south_texture

C 225,30,0

WE ./assets/path_to_the_west_texture
EA ./assets/path_to_the_east_texture
F 220,100,0
F 10,10,10
S ./assets/path_to_the_sprite_texture





    111111111
    122000011
    11111001
        1001
        1000111111111111111111111
        10N0000000110000000000001
        1011000001110000111100201
        10010000000000001  100001
111111111011000001110000111102001
1000000000110000011101111111111111
11110111111111011100000010001   1
11110111111111011101010010001
11000000110101011100000010001
10002000000000001100000010001
10000000000000001101010010001
110000011101010111110111100111
11110111 1110101 101111010001
11111111 1111111 111111111111