R 1000           800

NO ./assets/textures/space_closet.xpm
SO ./assets/textures/space_closet.xpm

C 225,   30,   0


WE ./assets/textures/space_closet.xpm
F 220,100,0
EA ./assets/textures/space_closet.xpm

        
        1111111111111111111111111
        10N0000000110000000000001
        1011000001110000111100001
        100100*0000000001  1000001
        1111111111111111111111111111111