R 1000           800

NO ./assets/textures/north_texture
SO ./assets/textures/south_texture

C 225,   30,   0


WE ./assets/textures/west_texture
F 220,100,0
EA ./assets/textures/east_texture
S ./assets/sprites/sprite_texture

        1               1
    111111111       1111111111111
    122000001       10010001
    11111001        1221001111
        1001        1001000011
        1000111111111001111011111
        10E0000000110000000000001
        1011000001110000111100201
        10010000000000001  100001
111111111011000001110000111102001
1000000000110000011101111111111111
11110111111111011100000010001   1
11110111111111011101010010001
11000000110101011100000010001
10002000000000001100000010001
10000000000000001101010010001
1100000111010101 1110111100111
1111011111110101 101111010001
11111111 1111111 111111111111