R 800           800

NO ./assets/textures/space_closet.xpm
SO ./assets/textures/space_door.xpm

C 122,   135,  159


EA ./assets/textures/space_cmd.xpm
F 64,73,89
WE ./assets/textures/space_win.xpm

        11111              1
    111111111       1111111111111
    100000001       10010001
    1111100111       1001001111
        100111       1001000011
        1011111111111001111011111
        1000000000000000000000001
        1001111001110000111100001
        1001000000000000100100001
111111111011000001110000111100001
1000000000110000011101111111111111
11110111111111011100000010001   1
11110111111111011101010010001
11000000110101011100000010001
100E00000000000001100000010001
10000000000000001101010010001
1100000111010101 1110111100111
1111011111110101 101111010001
11111111 1111111 111111111111