R            1000     800

NO ./assets/textures/eagle.xpm
SO ./assets/textures/greystone.xpm

C 137, 31, 30

WE ./assets/textures/purplestone.xpm
F 107,31,30
EA ./assets/textures/red.xpm

 1
1111
1S0111
1111 1
