R            1000     800

NO ./assets/textures/eagle.xpm
SO ./assets/textures/greystone.xpm

C 225, 30, 0

WE ./assets/textures/purplestone.xpm
F 220,100,0
EA ./assets/textures/red.xpm

 1
1111
1S0111
1111 1